Fatal Defect::Peterson, Ivars::science::english::usa
Burning Chrome::Gibson, William::sci fi::english::usa
Slouching Towards Bethlehem::Didion, Joan::essays::english::usa
Gateway::Pohl, Frederik::sci fi::english::usa
Story of the Eye::Bataille, Georges::erotica::french::france
Camp Concentration::Disch, Thomas M.::sci fi::english::usa
Chile, Death in the South::Timerman, Jacobo::history
Shah of Shahs::Kapuściński, Ryszard::history
Salvador::Didion, Joan::history::english::usa
Foundation and empire::Asimov, Isaac::sci fi::english::usa
Dr. Bloodmoney::Dick, Philip K.::sci fi::english::usa
Steve Jobs::Isaacson, Walter::biography::english::usa
Foundation (Foundation, #1)::Asimov, Isaac::sci fi::english::usa
Dune (Dune Chronicles, #1)::Herbert, Frank::sci fi::english::usa
Just for Fun::Torvalds, Linus::biography::english::usa
The Demolished Man::Bester, Alfred::sci fi::english::usa
What Just Happened::Gleick, James::science::english::usa
The Day of the Owl::Sciascia, Leonardo::literature::italian::italy
Gilgamesh: A Verse Narrative::Anonymous
The Emperor::Kapuściński, Ryszard::history::polish::poland
A Hunger Artist::Kafka, Franz::literature::german::czechoslovakia
Tales of Odessa::Babel, Isaac::literature::russian::ussr
Orbitsville::Shaw, Bob::science fiction::english
A Tomb for Boris Davidovich::Kiš, Danilo::literature::serbo-croatian::yugoslavia
Looking for History::Guillermoprieto, Alma::history
Introduction to the Philosophy of History::Hegel, Georg Wilhelm Friedrich::philosophy::german::germany
Ways of Seeing::Berger, John::art::english::england
Near to the Wild Heart::Lispector, Clarice::literature::portuguese::brazil
Just Kids::Smith, Patti::biography::english::usa
The Wrong End of Time::Brunner, John::sci fi::english::england
The Talented Mr. Ripley::Highsmith, Patricia::detective::english::england
Get Shorty::Leonard, Elmore::detective::english::usa
Trotsky for Beginners::Ali, Tariq::politics::english
Eye in the Sky::Dick, Philip K.::sci fi::english::usa
Roadside Picnic::Strugatsky, Arkady::sci fi::russian::ussr
The Invention of Morel::Casares, Adolfo Bioy::literature::spanish::argentina
Stranger in a Strange Land::Heinlein, Robert A.::sci fi::english::usa
Icehenge::Robinson, Kim Stanley::sci fi::english::usa
Sleepwalk and Other Stories::Tomine, Adrian::graphic novel::english::usa
The Last Days of Socrates::Plato::philosophy::greek::greece
Buddhism: A Very Short Introduction::Keown, Damien::literature::german::germany
Introducing Anthropology::Davies, Merryl Wyn::anthropology::english::usa
A Country Doctor::Kafka, Franz::literature::german::czechoslovakia
Contemplation::Kafka, Franz::literature::german::czechoslovakia
Tales of Belkin::Pushkin, Alexander::literature::russian::russia
Five Lectures on Psycho-Analysis::Freud, Sigmund::psychology::german::austria
The Catholic Church: A Short History::Küng, Hans::religion::german::germany
Mere Christianity::Lewis, C.S.::religion::english::england
Beyond the Pleasure Principle::Freud, Sigmund::psychology::german::austria
The Lost Honor of Katharina Blum::Böll, Heinrich::literature::german::germany
R.U.R.::Čapek, Karel::plays::czech::czechoslovakia
An Outline of Psycho-Analysis::Freud, Sigmund::psychology::german::austria
Literary Theory: An Introduction::Eagleton, Terry::lit crit::english::england
From Bauhaus to Our House::Wolfe, Tom::architecture::english::usa
Introducing Nietzsche::Gane, Laurence::philosophy::english
House of Mist: A Novel::Bombal, María Luisa::literature::spanish::chile
To Each His Own::Sciascia, Leonardo::literature::italian::italy
Doctor Glas::Söderberg, Hjalmar::literature::swedish::sweden
Introducing Hegel::Spencer, Lloyd::philosophy
Your Mother Was a Neanderthal::Scieszka, Jon::young adult::english::usa
2095::Scieszka, Jon::young adult::english::usa
Island of the Blue Dolphins::O'Dell, Scott::young adult::english::usa
Every Love Story Is a Ghost Story::Max, D.T.::biography
Paradise Lost::Milton, John::poetry::english::england
Beyond Good and Evil::Nietzsche, Friedrich::philosophy::german::germany
Speak::Anderson, Laurie Halse::young adult::english::usa
Othello::Shakespeare, William::plays::english::england
Hamlet::Shakespeare, William::plays::english::england
The Tempest::Shakespeare, William::plays::english::england
Hamlet::Shakespeare, William::plays::english::england
VALIS::Dick, Philip K.::sci fi::english::usa
Introducing Derrida::Collins, Jeff::philosophy
As You Like It::Shakespeare, William::plays::english::english
Introducing Bertrand Russell::Robinson, Dave::philosophy
Introducing Wittgenstein::Heaton, John::philosophy
Steps::Kosiński, Jerzy::literature::english::usa
Sir Gawain and the Green Knight::Unknown::literature::middle english::england
A Concise History of Germany::Fulbrook, Mary::history
One Day in the Life of Ivan Denisovich::Solzhenitsyn, Aleksandr::literature::russian::ussr
Paris Spleen::Baudelaire, Charles::poetry::french::france
The Call of Cthulhu and Other Weird Stories::Lovecraft, H.P.::horror::english::usa
The Foundation Pit::Platonov, Andrei::literature::russian::ussr
Jakob von Gunten::Walser, Robert::literature::german::switzerland
Stoner::Williams, John Edward::literature::english::usa
The Three Stigmata of Palmer Eldritch::Dick, Philip K.::sci fi::english::usa
The Kingdom of This World::Carpentier, Alejo::literature::spanish::cuba
The Fall::Camus, Albert::literature::french::france
She Stoops to Conquer::Goldsmith, Oliver::plays::english::england
Demian::Hesse, Hermann::literature::german::germany
Moravagine::Cendrars, Blaise::French::Switzerland
Moscow to the End of the Line::Yerofeyev, Venedikt::literature::russian::ussr
Pedro Páramo::Rulfo, Juan::literature::spanish::mexico
The History of Sexuality 1: An Introduction::Foucault, Michel::philosophy::french::france
Roxana::Defoe, Daniel::literature::english::england
Go Tell it on the Mountain::Baldwin, James::literature::english::usa
Narrative of the Life of Frederick Douglass::Douglass, Frederick::biography::english::usa
Oroonoko::Behn, Aphra::literature::english::england
Joseph Andrews::Fielding, Henry::literature::english::england
The Way of the World::Congreve, William::literature::english::england
The Joke::Kundera, Milan::literature::czech::czechoslovakia
Omon Ra::Pelevin, Victor::literature::russian::russia
The Possessed::Batuman, Elif::lit crit::english::usa
Players::DeLillo, Don::literature::english::usa
Uncle Vanya::Chekhov, Anton::plays::russian::russia
Zeno's Conscience::Svevo, Italo::literature::italian::italy
Epitaph of a Small Winner::Assis, Machado de::literature::portuguese::brazil
One Past Midnight: The Langoliers::King, Stephen::horror::english::usa
Night Shift::King, Stephen::horror::english::usa
The Beetle Leg::Hawkes, John::literature::english::usa
The Aleph and Other Stories::Borges, Jorge Luis::literature::spanish::argentina
Point Omega::DeLillo, Don::literature::english::usa
Dusklands::Coetzee, J.M.::literature::english::south africa
Molloy::Beckett, Samuel::literature::english::ireland
Dreaming of Babylon: A Private Eye Novel 1942::Brautigan, Richard::literature::english::usa
The Hawkline Monster: A Gothic Western::Brautigan, Richard::literature::english::usa
A Confederate General from Big Sur::Brautigan, Richard::literature::english::usa
Bright Lights, Big City::McInerney, Jay::literature::english::usa
Total Eclipse::Brunner, John::sci fi::english::england
The Brothers Karamazov::Dostoyevsky, Fyodor::literature::russian::russia
The Death of Ivan Ilyich and Other Stories::Tolstoy, Leo::literature::russian::russia
Walden; or, Life in the Woods::Thoreau, Henry David::philosophy::english::usa
Cathedral::Carver, Raymond::literature::english::usa
Invisible Cities::Calvino, Italo::literature::italian::italy
The Lime Twig::Hawkes, John::literature::english::usa
Moby-Dick; or, The Whale::Melville, Herman::literature::english::usa
Hatchet (Brian's Saga, #1)::Paulsen, Gary::young adult::english::usa
Nightwood::Barnes, Djuna::literature::english::usa
Absalom, Absalom!::Faulkner, William::literature::english::usa
The Tragedy of Mariam::Cary, Elizabeth::plays::English::England
The Circuit::Jiménez, Francisco::young adult::english::usa
Billy Budd and Other Stories::Melville, Herman::literature::english::usa
The Red Badge of Courage::Crane, Stephen::literature::english::usa
City of Quartz::Davis, Mike::history::english::usa
Ender's Game::Card, Orson Scott::sci fi::english::usa
Holes::Sachar, Louis::young adult::english::usa
Harry Potter and the Prisoner of Azkaban::Rowling, J.K.::young adult::english::usa
Harry Potter and the Chamber of Secrets::Rowling, J.K.::young adult::english::usa
Harry Potter and the Sorcerer's Stone::Rowling, J.K.::young adult::english::usa
Adventures of Huckleberry Finn::Twain, Mark::literature::english::usa
The Sound and the Fury::Faulkner, William::literature::english::usa
Monster::Myers, Walter Dean::young adult::english::usa
To Kill a Mockingbird::Lee, Harper::literature::english::usa
As I Lay Dying::Faulkner, William::literature::english::usa
The Death of Ivan Ilych::Tolstoy, Leo::literature::russian::russia
The House of Mirth::Wharton, Edith::literature::english::usa
Sister Carrie::Dreiser, Theodore::literature::english::usa
The White Album::Didion, Joan::essays::english::usa
Bring the Jubilee::Moore, Ward::sci fi::english::usa
The Perks of Being a Wallflower::Chbosky, Stephen::young adult::english::usa
Romeo and Juliet::Shakespeare, William::plays::english::england
The Penultimate Truth::Dick, Philip K.::sci fi::english::usa
The Chrysalids::Wyndham, John::sci fi::english::england
Making Sense of the Troubles::McKittrick, David::history::english
A Place in Space::Snyder, Gary::essays::english::usa
Diary of a Mosquito Abatement Man::Porcellino, John::graphic novel::english::usa
The Big Empty::Mailer, Norman::essays::english::usa
Grand Inquisitor::Dostoyevsky, Fyodor::literature::russian::russia
Despite Everything: A Cometbus Omnibus::Cometbus, Aaron::literature::english::usa
Double Duce::Cometbus, Aaron::literature::english::usa
Alabama Wildman::Moore, Thurston::poetry::english::usa
No Country for Old Men::McCarthy, Cormac::literature::english::usa
Do Androids Dream of Electric Sheep?::Dick, Philip K.::sci fi::english::usa
Pulp::Bukowski, Charles::literature::english::usa
Jack London: A Life::Kershaw, Alex::biography::english::usa
The Nasty Bits::Bourdain, Anthony::essays::english::usa
Galápagos::Vonnegut, Kurt::literature::english::usa
Malcolm::Perry, Bruce::biography::english::usa
Hammer of the Gods::Davis, Stephen::music::english
Stairway to Heaven: Led Zeppelin Uncensored::Cole, Richard::music::english
The Ugly American::Lederer, William J.::literature::english::usa
Bad Blood: A Family Murder in Marin County::Levine, Richard M.::true crime::english::usa
The Populist Moment::Goodwyn, Lawrence::history::english::usa
Buddy Does Jersey, 1994-1998::Bagge, Peter::graphic novel::english::usa
Buddy Does Seattle, 1990-1994::Bagge, Peter::graphic novel::english::usa
Stupid White Men::Moore, Michael::politics::english::usa
Downsize This!::Moore, Michael::politics::english::usa
Hickory Wind::Fong-Torres, Ben::music::english::usa
The Worms of Kukumlima::Pinkwater, Daniel::young adult::english::usa
The Snarkout Boys and the Avocado of Death::Pinkwater, Daniel::young adult::english::usa
The Snarkout Boys and the Baconburg Horror::Pinkwater, Daniel::young adult::english::usa
Lizard Music::Pinkwater, Daniel::young adult::english::usa
The Handmaid's Tale::Atwood, Margaret::literature::english::canada
The Castle of Otranto::Walpole, Horace::literature::english::england
The Day of the Locust::West, Nathanael::literature::english::usa
A Brief History of Time::Hawking, Stephen::science::english::england
The Homecoming::Pinter, Harold::plays::english::england
The Cannibal::Hawkes, John::literature::english::usa
Blood Meridian::McCarthy, Cormac::literature::english::usa
Jane Eyre::Brontë, Charlotte::literature::english::england
Summertime::Coetzee, J.M.::literature::english::south africa
Cane::Toomer, Jean::literature::english::usa
Disgrace::Coetzee, J.M.::literature::english::south africa
Look Back in Anger::Osborne, John::plays::english::england
Hard Times::Dickens, Charles::literature::english::england
The Road::McCarthy, Cormac::literature::english::usa
Cold Mountain::Frazier, Charles::literature::english::usa
Macbeth::Shakespeare, William::plays::english::england
Jackson Pollock: A Biography::Solomon, Deborah::biography::english::usa
The Pearl::Steinbeck, John::literature::english::usa
Introducing Heidegger::Collins, Jeff::philosophy
How to Travel with a Salmon::Eco, Umberto::essays::italian::italy
Voices of the Self::Gilyard, Keith::composition::english::usa
The Eyre Affair (Thursday Next, #1)::Fforde, Jasper::sci fi::english::england
Nature and Walking::Emerson, Ralph Waldo::philosophy::english::usa
Emma::Austen, Jane::literature::english::england
Self-Reliance and Other Essays::Emerson, Ralph Waldo::philosophy::english::usa
Incidents in the Life of a Slave Girl::Jacobs, Harriet::history::english::usa
A Modest Proposal::Swift, Jonathan::literature::english::england
In the Heart of the Country::Coetzee, J.M.::literature::english::south africa
The Soft Machine::Burroughs, William S.::literature::english::usa
Ecotopia::Callenbach, Ernest::sci fi::english::usa
Wide Sargasso Sea::Rhys, Jean::literature::english::england
Wieland::Brown, Charles Brockden::literature::english::usa
What We Talk About When We Talk About Love::Carver, Raymond::literature::english::usa
If on a Winter's Night a Traveler::Calvino, Italo::literature::italian::italy
The Metamorphosis::Kafka, Franz::literature::german::czechoslovakia
The Metamorphosis, the Penal Colony, and Other Stories::Kafka, Franz::literature::german::czechoslovakia
Timequake::Vonnegut, Kurt::literature::english::usa
Ubik::Dick, Philip K.::sci fi::english::usa
From the Mixed-Up Files of Mrs. Basil E. Frankweiler::Konigsburg, E.L.::young adult::english::usa
We::Zamyatin, Yevgeny::literature::russian::ussr
Fathers and Sons::Turgenev, Ivan::literature::russian::russia
Notes From Underground::Dostoyevsky, Fyodor::literature::russian::russia
A Raisin in the Sun::Hansberry, Lorraine::plays::english::usa
A Teaching Subject: Composition Since 1966::Harris, Joseph::composition::english::usa
Native Son::Wright, Richard::literature::english::usa
Miss Lonelyhearts & The Day of the Locust::West, Nathanael::literature::english::usa
Who's Afraid of Virginia Woolf?::Albee, Edward::plays::english::usa
Death of a Salesman::Miller, Arthur::plays::english::usa
A Streetcar Named Desire::Williams, Tennessee::plays::english::usa
The Country of the Pointed Firs and Other Stories::Jewett, Sarah Orne::literature::english::usa
The Awakening::Chopin, Kate::literature::english::usa
Cloud Nine::Churchill, Caryl::plays::english::england
Waiting for Godot::Beckett, Samuel::plays::english::ireland
The Importance of Being Earnest::Wilde, Oscar::plays::english::england
Pamela. Or, Virtue Rewarded::Richardson, Samuel::literature::english::england
Gulliver's Travels::Swift, Jonathan::literature::english::england
Doctor Faustus::Marlowe, Christopher::plays::english::england
The Playboy of the Western World & Riders to the Sea::Synge, J.M.::plays::english::ireland
Wuthering Heights::Brontë, Emily::literature::english::england
Mrs. Dalloway::Woolf, Virginia::literature::english::england
Gravity's Rainbow::Pynchon, Thomas::literature::english::usa
A Portrait of the Artist as a Young Man::Joyce, James::literature::english::ireland
Dubliners::Joyce, James::literature::english::ireland
The Unbearable Lightness of Being::Kundera, Milan::literature::czech::czechoslovakia
The Sorrows of Young Werther::Goethe, Johann Wolfgang von::literature::german::germany
Wild at Heart::Gifford, Barry::literature::english::usa
I and My Chimney::Melville, Herman::literature::english::usa
Howard Hughes: The Untold Story::Brown, Peter Harry::history::english::usa
The Barbary Coast::Asbury, Herbert::history::english::usa
The Samurai's Garden::Tsukiyama, Gail::literature::english::usa
The Social Construction of Reality::Berger, Peter L.::philosophy::english::usa
Kangaroo Notebook::Abe, Kōbō::literature::japanese::japan
Stalin's Spy::Whymant, Robert::history
The Cherry Orchard::Chekhov, Anton::plays::russian::russia
Touching from a Distance: Ian Curtis and Joy Division::Curtis, Deborah::music::english::england
Introducing Fascism and Nazism::Hood, Stuart::politics
Heartbreak House::Shaw, George Bernard::plays::english::england
Pale Fire::Nabokov, Vladimir::literature::english::usa
The Postmodern Condition::Lyotard, Jean-François::philosophy::french::france
The Public Burning::Coover, Robert::literature::english::usa
Planet of the Apes::Boulle, Pierre::sci fi:: french::france
Waiting for the Barbarians::Coetzee, J.M.::literature::english::south africa
When You Are Engulfed in Flames::Sedaris, David::essays::english::usa
Dress Your Family in Corduroy and Denim::Sedaris, David::essays::english::usa
Me Talk Pretty One Day::Sedaris, David::essays::english::usa
The Piano Tuner::Mason, Daniel::literature::english::usa
Bel Canto::Patchett, Ann::literature::english::usa
Mountains Beyond Mountains::Kidder, Tracy::history::english::usa
Acid Dreams::Lee, Martin A.::history::english::usa
Eating the Dinosaur::Klosterman, Chuck::essays::english::usa
Chuck Klosterman IV::Klosterman, Chuck::essays::english::usa
American Studies in a Moment of Danger::Lipsitz, George
Inherent Vice::Pynchon, Thomas::literature::english::usa
Sartor Resartus::Carlyle, Thomas::literature::english::england
Ficciones::Borges, Jorge Luis::literature::spanish::argentina
Consider the Lobster and Other Essays::Wallace, David Foster::essays::english::usa
American Hardcore: A Tribal History::Blush, Steven::music::english::usa
Confusion Is Next: The Sonic Youth Story::Foege, Alec::music::english::usa
Our Band Could Be Your Life::Azerrad, Michael::music::english::usa
The Giver::Lowry, Lois::young adult::english::usa
The Crucible::Miller, Arthur::plays::english::usa
Speak::Anderson, Laurie Halse::young adult::english::usa
Persepolis: The Story of a Childhood::Satrapi, Marjane::graphic novel
Persepolis 2: The Story of a Return::Satrapi, Marjane::graphic novel
To Kill a Mockingbird::Lee, Harper::literature::english::usa
Night (The Night Trilogy, #1)::Wiesel, Elie::literature
A Separate Peace::Knowles, John::literature::english::usa
Cry, the Beloved Country::Paton, Alan::literature::english::south africa
Critical Theory Today::Tyson, Lois::lit crit
Rolling Stone's Alt-Rock-A-Rama::Schinder, Scott::music::english::usa
Main Lines, Blood Feasts, and Bad Taste::Bangs, Lester::music::english::usa
Let it Blurt::Derogatis, Jim::biography::english::usa
Basquiat: A Quick Killing in Art::Hoban, Phoebe::biography::english::usa
The Philosophy of Andy Warhol::Warhol, Andy::art::english::usa
POPism: The Warhol Sixties::Warhol, Andy::art::english::usa
Rendezvous with Rama (Rama, #1)::Clarke, Arthur C.::sci fi::english::england
Time Out Of Joint::Dick, Philip K.::sci fi::english::usa
The Secret Agent::Conrad, Joseph::literature::english::england
Sons and Lovers::Lawrence, D.H.::literature::english::england
To the Lighthouse::Woolf, Virginia::literature::english::england
Ulysses::Joyce, James::literature::english::ireland::1922
An Uncommon Friendship::Rosner, Bernat::history
King Leopold's Ghost::Hochschild, Adam::history
Agent Zigzag::Macintyre, Ben::history
Being There::Kosiński, Jerzy::literature::english::usa
Cash::Cash, Johnny::music::english::usa
The Dirt::Lee, Tommy::music::english::usa
Ghost World::Clowes, Daniel::graphic novel::english::usa
Howl and Other Poems::Ginsberg, Allen::poetry::english::usa
Once in a Promised Land::Halaby, Laila::literature::english::usa
The Clash of Barbarisms::Achcar, Gilbert::politics
Futuretrack 5::Westall, Robert::sci fi::english
Across a Hundred Mountains::Grande, Reyna::literature::english::usa
A Man Without a Country::Vonnegut, Kurt::essays::english::usa
Radio Free Albemuth::Dick, Philip K.::sci fi::english::usa
A Room of One's Own::Woolf, Virginia::essays::english::england
Of Mice and Men::Steinbeck, John::literature::english::usa
The Sun Also Rises::Hemingway, Ernest::literature::english::usa
Lord of the Flies::Golding, William::literature::english::england
Into the Wild::Krakauer, Jon::non fiction::english::usa
Heart of Darkness and the Congo Diary::Conrad, Joseph::literature::english::england
How to Read Derrida::Deutscher, Penelope::philosophy
How to Read Lacan::Žižek, Slavoj::psychology
Violence::Žižek, Slavoj::politics
The Andromeda Strain::Crichton, Michael::sci fi::english::usa
Brave New World::Huxley, Aldous::literature::english::england
The Tin Drum::Grass, Günter::literature::german::germany
A Doll's House::Ibsen, Henrik::plays::norwegian::norway
Ghosts::Ibsen, Henrik::plays::norwegian::norway
In the Empire of Genghis Khan::Stewart, Stanley::travel::english
My Childhood::Gorky, Maxim::literature::russian::russia
Burning in Water, Drowning in Flame::Bukowski, Charles::poetry::english::usa
Teach Yourself Postmodernism::Ward, Glenn::philosophy
Introducing Postmodernism::Appignanesi, Richard::philosophy
A Short History of Guatemala::Woodward, Ralph Lee::history
V for Vendetta::Moore, Alan::graphic novel::english::england
Watchmen::Moore, Alan::graphic novel::english::england
The Concept of the Political::Schmitt, Carl::politics::german::germany
Capitalism and Freedom::Friedman, Milton::politics::english::usa
The Marxist System::Freedman, Robert::politics
Unmaking the Public University::Newfield, Christopher::politics
Trainspotting::Welsh, Irvine::literature::english::scotland
Candide::Voltaire::literature::french::france
The Sirens of Titan::Vonnegut, Kurt::literature::english::usa
Player Piano::Vonnegut, Kurt::literature::english::usa
God Bless You, Mr. Rosewater::Vonnegut, Kurt::literature::english::usa
Bluebeard::Vonnegut, Kurt::literature::english::usa
Deadeye Dick::Vonnegut, Kurt::literature::english::usa
Slapstick, or Lonesome No More!::Vonnegut, Kurt
Cat's Cradle::Vonnegut, Kurt::literature::english::usa
Slaughterhouse-Five::Vonnegut, Kurt::literature::english::usa
The Adventures of Huckleberry Finn::Twain, Mark::literature::english::usa
Why I Am Not a Christian::Russell, Bertrand::philosophy::english::england
A Confederacy of Dunces::Toole, John Kennedy::literature::english::usa
The Catcher in the Rye::Salinger, J.D.::literature::english::usa
Nine Stories::Salinger, J.D.::literature::english::usa
Ceremony::Silko, Leslie Marmon::literature::english::usa
The Oedipus Cycle::Sophocles::plays::greek::greece
Rosencrantz and Guildenstern Are Dead::Stoppard, Tom::plays::english::england
Existentialism and Human Emotions::Sartre, Jean-Paul::philosophy::french::france
No Exit and Three Other Plays::Sartre, Jean-Paul::plays::french::france
The Sovereignty and Goodness of God::Rowlandson, Mary::history::english::usa
Narrative of Sojourner Truth::Truth, Sojourner::history::english::usa
Tempest::Shakespeare, William::plays::english::england
The Magic Christian::Southern, Terry::literature::english::usa
Housekeeping::Robinson, Marilynne::literature::english::usa
Portnoy's Complaint::Roth, Philip::literature::english::usa
The Ghost Writer::Roth, Philip::literature::english::usa
Zuckerman Unbound::Roth, Philip::literature::english::usa
The Plough and the Stars::O'Casey, Seán::plays::english::ireland
Nineteen Eighty-Four::Orwell, George::literature::english::england
Facing Unpleasant Facts: Narrative Essays::Orwell, George::essays::english::england
Animal Farm::Orwell, George::literature::english::england
The Annotated Lolita::Nabokov, Vladimir::literature::english::usa
American Buffalo::Mamet, David::plays::english::usa
Glengarry Glen Ross::Mamet, David::plays::english::usa
The Iron Heel::London, Jack::literature::english::usa
The Spy Who Came In from the Cold::Carré, John le::literature::english::england
The Rain God: A Desert Tale::Islas, Arturo::literature::english::usa
Their Eyes Were Watching God::Hurston, Zora Neale::literature::english::usa
High Fidelity::Hornby, Nick::literature::english::england
M. Butterfly::Hwang, David Henry::plays::english::usa
The Great Gatsby::Fitzgerald, F. Scott::literature::english::usa
The Autobiography of Benjamin Franklin::Franklin, Benjamin::biography::english::usa
The 42nd Parallel::Passos, John Dos::literature::english::usa
The Sport of the Gods::Dunbar, Paul Laurence::literature::english::usa
The Man in the High Castle::Dick, Philip K.::sci fi::english::usa
In Cold Blood::Capote, Truman::true crime::english::usa
Breakfast at Tiffany's::Capote, Truman::literature::english::usa
The Stranger::Camus, Albert::literature::french::france
The Plague::Camus, Albert::literature::french::france
Falconer::Cheever, John::literature::english::usa
Forced Entries: The Downtown Diaries: 1971-1973::Carroll, Jim::literature::english::usa
The Basketball Diaries::Carroll, Jim::literature::english::usa
The Thirty-Nine Steps::Buchan, John::literature::english::england
The Contortionist's Handbook::Clevenger, Craig::literature::english::usa
Beloved::Morrison, Toni::literature::english::usa
Pynchon: A Collection of Critical Essays::Mendelson, Edward::lit crit::english::usa
Light in August::Faulkner, William::literature::english::usa
As I Lay Dying::Faulkner, William::literature::english::usa
The Sound and the Fury::Faulkner, William::literature::english::usa
Absalom, Absalom!::Faulkner, William::literature::english::usa
Ragtime::Doctorow, E.L.::literature::english::usa
The Scarlet Letter::Hawthorne, Nathaniel::literature::english::usa
Angle of Repose::Stegner, Wallace::literature::english::usa
A Hazard of New Fortunes::Howells, William Dean::literature::english::usa
McTeague::Norris, Frank::literature::english::usa
Looking Backward::Bellamy, Edward::literature::english::usa
Women::Bukowski, Charles::literature::english::usa
Factotum::Bukowski, Charles::literature::english::usa
Post Office::Bukowski, Charles::literature::english::usa
Hocus Pocus::Vonnegut, Kurt::literature::english::usa
A Scanner Darkly::Dick, Philip K.::sci fi::english::usa
Please Kill Me::McNeil, Legs::music::english::usa
The Name of the Rose::Eco, Umberto::literature::italian::italy
Killing Yourself to Live: 85% of a True Story::Klosterman, Chuck::music::english::usa
A Supposedly Fun Thing I'll Never Do Again::Wallace, David Foster::essays::english::usa
Fargo Rock City::Klosterman, Chuck::music::english::usa
Sex, Drugs, and Cocoa Puffs::Klosterman, Chuck::essays::english::usa
How Soon Is Never?::Spitz, Marc::literature::english::usa
White Noise::DeLillo, Don::literature::english::usa
The Portrait of a Lady::James, Henry::literature::english::usa
Frankenstein::Shelley, Mary::literature::english::england
Bartleby and Benito Cereno::Melville, Herman::literature::english::usa
Moby-Dick::Melville, Herman::literature::english::usa
Vineland::Pynchon, Thomas::literature::english::usa
Faust, Part I, Vol. 1::Goethe, Johann Wolfgang von::literature::german::germany
Death in Venice::Mann, Thomas::literature::german::germany
Less Than Zero::Ellis, Bret Easton::literature::english::usa
The Rules of Attraction::Ellis, Bret Easton::literature::english::usa
Hell's Angels: A Strange and Terrible Saga::Thompson, Hunter S.::non fiction::english::usa
The Great Shark Hunt::Thompson, Hunter S.::non fiction::english::usa
The Rum Diary::Thompson, Hunter S.::literature::english::usa
Fear and Loathing in Las Vegas::Thompson, Hunter S.::literature::english::usa
One Flew Over the Cuckoo's Nest::Kesey, Ken::literature::english::usa
Invisible Man::Ellison, Ralph::literature::english::usa
A Companion to The Crying of Lot 49::Grant, J. Kerry::lit crit::english::usa
The Crying of Lot 49::Pynchon, Thomas::literature::english::usa
On the Road::Kerouac, Jack::literature::english::usa
Tropic of Cancer::Miller, Henry::literature::english::usa
Quiet Days in Clichy::Miller, Henry::literature::english::usa
Big Sur::Kerouac, Jack::literature::english::usa
The Dharma Bums::Kerouac, Jack::literature::english::usa
Trout Fishing in America::Brautigan, Richard::literature::english::usa
Get in the Van: On the Road With Black Flag::Rollins, Henry::music::english::usa
The Voyage Out::Woolf, Virginia::literature::english::england
The Rainbow::Lawrence, D.H.::literature::english::england
Anthem::Rand, Ayn::literature::english::usa
Lucky Jim::Amis, Kingsley::literature::english::england
